[INFO]
id=1
name=Crystal Caves
floors=3
minLevel=1
encounterRate=20
enemies=1,2,3,7

[FLOOR1]
map=0000000000000000
map=0009111111110000
map=0001001001011000
map=0011111111111100
map=0010010110010100
map=0011111111111100
map=0001001005011000
map=0011111111111100
map=0010010110010100
map=0011111111111100
map=0000001311000000
map=0000000000000000

[FLOOR2]
map=0000000000000000
map=0000411111000000
map=0001101101110000
map=0011111111111000
map=0010050010011100
map=0011111111110100
map=0001100011111100
map=0011110111010100
map=0010011101011100
map=0011111111111000
map=0000011310000000
map=0000000000000000

[FLOOR3]
map=0000000000000000
map=0000041111100000
map=0001110001110000
map=0011100500111000
map=0010111111011100
map=0011100100101100
map=0001101110111000
map=0011111111110000
map=0010100101010000
map=0011111111110000
map=0000011110000000
map=0000000000000000
