[INFO]
id=2
name=Goblin Warrens
floors=4
minLevel=3
encounterRate=25
enemies=4,5,6,7,11

[FLOOR1]
map=0000000000000000
map=0091111100111100
map=0010010100100100
map=0011111111111100
map=0001001010010000
map=0011111111110000
map=0010100101011100
map=0011110111010100
map=0001010101011100
map=0011111111111000
map=0000001310000000
map=0000000000000000

[FLOOR2]
map=0000000000000000
map=0004111001111000
map=0011001011001100
map=0010111111101100
map=0011100100111000
map=0001111111110000
map=0011005010011000
map=0010111111101100
map=0011100100111000
map=0001111111110000
map=0000001310000000
map=0000000000000000

[FLOOR3]
map=0000000000000000
map=0000411111100000
map=0001100001110000
map=0011011101011000
map=0010110010111000
map=0011111111101100
map=0001005100011000
map=0011111111111000
map=0010100100101000
map=0011111111111000
map=0000001310000000
map=0000000000000000

[FLOOR4]
map=0000000000000000
map=0000041111000000
map=0001110001100000
map=0011100501110000
map=0010111110011000
map=0011000011111000
map=0011101100010000
map=0010111111011000
map=0011100101111000
map=0001111111100000
map=0000011100000000
map=0000000000000000
