[INFO]
id=3
name=Shadow Tower
floors=5
minLevel=6
encounterRate=30
enemies=8,9,10,12,13

[FLOOR1]
map=0000000000000000
map=0091111111111100
map=0010010100100100
map=0011111111111100
map=0001001010010100
map=0011111111111100
map=0010010100100100
map=0011111111111100
map=0010010110010100
map=0011111111111100
map=0000001310000000
map=0000000000000000

[FLOOR2]
map=0000000000000000
map=0004111111110000
map=0011001010011000
map=0010111111101100
map=0011005010010100
map=0001111111111100
map=0011001010011000
map=0010111111101100
map=0011100100111000
map=0001111111110000
map=0000001310000000
map=0000000000000000

[FLOOR3]
map=0000000000000000
map=0000411111100000
map=0001100100110000
map=0011111111111000
map=0010010110010100
map=0011111111111100
map=0001005101110000
map=0011111111011000
map=0010010100111000
map=0011111111110000
map=0000001310000000
map=0000000000000000

[FLOOR4]
map=0000000000000000
map=0000041111000000
map=0001110001100000
map=0011100101110000
map=0010011110011000
map=0011110011101000
map=0001001100011000
map=0011111111111000
map=0010050100101000
map=0011111111111000
map=0000001310000000
map=0000000000000000

[FLOOR5]
map=0000000000000000
map=0000001110000000
map=0000411111000000
map=0001110001110000
map=0001100500110000
map=0011110101111000
map=0010011011001100
map=0011110101111000
map=0001108001110000
map=0000111111000000
map=0000011100000000
map=0000000000000000
